Gs^Fms, Gs^Fms, Gs^Fms, Gs^Fms, Gs^Fms, Gs^Fms, Gs^Fms, Gs^Fms, Gs^Fms, Gs^Fms, Gs^Fms, Gs^Fms, Gs^Fms, Gs^Fms, Gs^Fms, Gs^Fms, Gs^Fms, Gs^Fms, Gs^Fms, Gs^Fms, Gs^Fms, Gs^Fms, Gs^Fms, Gs^Fms, Gs^Fms, Gs^Fms, Gs^Fms, Gs^Fms
Gs^Fms, Gs^Fms, Gs^Fms, Gs^Fms, Gs^Fms, Gs^Fms, Gs^Fms, Gs^Fms, Gs^Fms, Gs^Fms, Gs^Fms, Gs^Fms, Gs^Fms, Gs^Fms, Gs^Fms, Gs^Fms, Gs^Fms, Gs^Fms, Gs^Fms, Gs^Fms, Gs^Fms, Gs^Fms, Gs^Fms, Gs^Fms, Gs^Fms, Gs^Fms, Gs^Fms, Gs^Fms
Gs^Fms, Gs^Fms, Gs^Fms, Gs^Fms, Gs^Fms, Gs^Fms, Gs^Fms, Gs^Fms, Gs^Fms, Gs^Fms, Gs^Fms, Gs^Fms, Gs^Fms, Gs^Fms, Gs^Fms, Gs^Fms, Gs^Fms, Gs^Fms, Gs^Fms, Gs^Fms, Gs^Fms, Gs^Fms, Gs^Fms, Gs^Fms, Gs^Fms, Gs^Fms, Gs^Fms, Gs^Fms
Gs^Fms, Gs^Fms, Gs^Fms, Gs^Fms, Gs^Fms, Gs^Fms, Gs^Fms, Gs^Fms, Gs^Fms, Gs^Fms, Gs^Fms, Gs^Fms, Gs^Fms, Gs^Fms, Gs^Fms, Gs^Fms, Gs^Fms, Gs^Fms, Gs^Fms, Gs^Fms, Gs^Fms, Gs^Fms, Gs^Fms, Gs^Fms, Gs^Fms, Gs^Fms, Gs^Fms, Gs^Fms
Gs^Fms, Gs^Fms, Gs^Fms, Gs^Fms, Gs^Fms, Gs^Fms, Gs^Fms, Gs^Fms, Gs^Fms, Gs^Fms, Gs^Fms, Gs^Fms, Gs^Fms, Gs^Fms, Gs^Fms, Gs^Fms, Gs^Fms, Gs^Fms, Gs^Fms, Gs^Fms, Gs^Fms, Gs^Fms, Gs^Fms, Gs^Fms, Gs^Fms, Gs^Fms, Gs^Fms, Gs^Fms
Gs^Fms, Gs^Fms, Gs^Fms, Gs^Fms, Gs^Fms, Gs^Fms, Gs^Fms, Gs^Fms, Gs^Fms, Gs^Fms, Gs^Fms, Gs^Fms, Gs^Fms, Gs^Fms, Gs^Fms, Gs^Fms, Gs^Fms, Gs^Fms, Gs^Fms, Gs^Fms, Gs^Fms, Gs^Fms, Gs^Fms, Gs^Fms, Gs^Fms, Gs^Fms, Gs^Fms, Gs^Fms
Gs^Fms, Gs^Fms, Gs^Fms, Gs^Fms, Gs^Fms, Gs^Fms, Gs^Fms, Gs^Fms, Gs^Fms, Gs^Fms, Gs^Fms, Gs^Fms, Gs^Fms, Gs^Fms, Gs^Fms, Gs^Fms, Gs^Fms, Gs^Fms, Gs^Fms, Gs^Fms, Gs^Fms, Gs^Fms, Gs^Fms, Gs^Fms, Gs^Fms, Gs^Fms, Gs^Fms, Gs^Fms
Gs^Fms, Gs^Fms, Gs^Fms, Gs^Fms, Gs^Fms, Gs^Fms, Gs^Fms, Gs^Fms, Gs^Fms, Gs^Fms, Gs^Fms, Gs^Fms, Gs^Fms, Gs^Fms, Gs^Fms, Gs^Fms, Gs^Fms, Gs^Fms, Gs^Fms, Gs^Fms, Gs^Fms, Gs^Fms, Gs^Fms, Gs^Fms, Gs^Fms, Gs^Fms, Gs^Fms, Gs^Fms
Gs^Fms, Gs^Fms, Gs^Fms, Gs^Fms, Gs^Fms, Gs^Fms, Gs^Fms, Gs^Fms, Gs^Fms, Gs^Fms, Gs^Fms, Gs^Fms, Gs^Fms, Gs^Fms, Gs^Fms, Gs^Fms, Gs^Fms, Gs^Fms, Gs^Fms, Gs^Fms, Gs^Fms, Gs^Fms, Gs^Fms, Gs^Fms, Gs^Fms, Gs^Fms, Gs^Fms, Gs^Fms
Gs^Fms, Gs^Fms, Gs^Fms, Gs^Fms, Gs^Fms, Gs^Fms, Gs^Fms, Gs^Fms, Gs^Fms, Gs^Fms, Gs^Fms, Gs^Fms, Gs^Fms, Gs^Fms, Gs^Fms, Gs^Fms, Gs^Fms, Gs^Fms, Gs^Fms, Gs^Fms, Gs^Fms, Gs^Fms, Gs^Fms, Gs^Fms, Gs^Fms, Gs^Fms, Gs^Fms, Gs^Fms
Gs^Fms, Gs^Fms, Gs^Fms, Gs^Fms, Gs^Fms, Gs^Fms, Gs^Fms, Gs^Fms, Gs^Fms, Gs^Fms, Gs^Fms, Gs^Fms, Gs^Fms, Gs^Fms, Gs^Fms, Gs^Fms, Gs^Fms, Gs^Fms, Ms^Xm, Gs^Fms, Aa^Fpa, Gs^Fms, Gs^Fms, Gs^Fms, Gs^Fms, Gs^Fms, Gs^Fms, Gs^Fms
Gs^Fms, Gs^Fms, Gs^Fms, Gs^Fms, Gs^Fms, Gs^Fms, Gs^Fms, Gs^Fms, Gs^Fms, Gs^Fms, Gs^Fms, Gs^Fms, Gs^Fms, Gs^Fms, Gs^Fms, Gs^Fms, Ms^Xm, Ms^Xm, Gll^Ftr, Aa^Fpa, Gll^Ftr, Aa^Fpa, Aa^Fpa, Gs^Fms, Gs^Fms, Gs^Fms, Gs^Fms, Gs^Fms
Hh, Gs^Fms, Gs^Fp, Gs^Fms, Rr, Rr, Rr, Gs^Fms, Gs^Fms, Gs^Fp, Gs^Fms, Gs^Fms, Gs^Fms, Gs^Fp, Gs^Fp, Ms^Xm, Gll^Ftr, Gll^Ftr, Gll^Ftr, Gll^Ftr, Gll^Ftr, Gll^Ftr, Gll^Ftr, Aa^Fpa, Gll^Ftr, Gs^Fms, Gs^Fms, Gs^Fms
Rr, Gs^Fp, Rr, Rr, Aa, Aa, Rr, Gs^Fms, Ds, Ds, Gs^Fms, Gs^Fms, Gs^Fms, Gs^Fp, Gll^Ftr, Gll^Ftr, Gll^Ftr, Gll^Ftr, Wot, Gll^Ftr, Wo, Gll^Ftr, Gll^Ftr, Gll^Ftr, Gll^Ftr, Gll^Ftr, Gs^Fms, Gs^Fms
Ww, Rr, Gg, Gg, Gg, Aa, Rr, Gs^Fms, Gs^Fms, Gs^Fms, Gs^Fms, Gs^Fms, Gs^Fms, Gll^Ftr, Gll^Ftr, Gll^Ftr, Wot, Wot, Wot, Wo, Mdd^Xm, Wo, Wo, Gll^Ftr, Gll^Ftr, Gll^Ftr, Gs^Fms, Gs^Fms
Ww, 1 Gg, Gg, Gg, Rr, Rr, Gs^Fms, Gs^Fms, Aa, Aa, Aa, Aa, Gs^Fms, Gll^Ftr, Gll^Ftr, Gll^Ftr, Wot, Wot, Wot, Wo, Wo, Wo, Wot, Wot, Gll^Ftr, Gll^Ftr, Gs^Fms, Gs^Fms
Ww, Ww, Gs^Fms, Gs^Fms, Gs^Fms, Ds, Gs^Fms, Aa, Aa, Aa, Aa, Aa, Gs^Fms, Gll^Ftr, Gll^Ftr, Wot, Wot, Wot, Wwf, Gs^Efm, Wot, Wot, Wot, Wot, Gll^Ftr, Gll^Ftr, Gg^Vh, Gs^Fms
Ww, Ww, Rr, Rr, Gs^Fms, Gs^Fms, Gs^Fms, Aa, Aa, Aa, Aa, Aa, Aa, Gll^Ftr, Gll^Ftr, Wot, Wot, Wwf^Efs, Wot, Wot, Wot, Wot, Gll^Ftr, Wot, Gll^Ftr, Gll^Ftr, Gs^Fms, Gs^Fms
Gg, Gs^Fms, Rr, Gs^Fms, Gs^Fms, Gs^Fms, Aa, Aa, Aa, Aa, Aa, Aa, Aa, Gll^Ftr, Gll^Ftr, Wot, Wot, Wwf, Wwf, Wot, Gll^Ftr, Gll^Ftr, Gll^Ftr, Gll^Ftr, Gll^Ftr, Gll^Ftr, Gs^Fms, Gs^Fms
Gg, Gg, Rr, Gs^Fms, Gs^Fms, Aa, Aa, Aa, Aa, Aa, Gs^Fms, Gs^Fms, Gs^Fms, Gll^Ftr, Gll^Ftr, Wot, Wot, Wot, Gll^Ftr, Sm, Gll^Ftr, Gll^Ftr, Gll^Ftr, Gll^Ftr, Gll^Ftr, Gll^Ftr, Gs^Fp, Gs^Fms
Gg, Gg, Rr, Gs^Fms, Gs^Fms, Aa, Aa, Aa, Aa, Aa, Gs^Fms, Gs^Fms, Gs^Fms, Gll^Ftr, Gll^Ftr, Gll^Ftr, Gll^Ftr, Gll^Ftr, Gll^Ftr, Sm, Gs^Ft, Gll^Ftr, Gll^Ftr, Gll^Ftr, Gll^Ftr, Gll^Ftr, Gs^Fms, Gs^Fms
Ha, Gg, Gg, Rr, Gs^Fms, Gs^Fms, Gs^Fms, Gs^Fms, Aa, Aa, Gs^Fms, Gs^Fms, Gs^Fms, Gll^Ftr, Gll^Ftr, Gll^Ftr, Gll^Ftr, Gs^Ft, Gll^Ftr, Sm, Gs^Ft, Gll^Ftr, Gll^Ftr, Gll^Ftr, Gll^Ftr, Gll^Ftr, Gs^Fms, Gs^Fms
Gg, Gg, Gg, Rr, Gs^Fms, Gs^Fms, Gs^Fms, Gs^Fms, Aa, Gs^Fms, Gs^Fms, Gs^Fms, Gs^Fms, Gll^Ftr, Gll^Ftr, Gll^Ftr, Gll^Ftr, Gll^Ftr, Gll^Ftr, Sm, Gll^Ftr, Gll^Ftr, Gll^Ftr, Gll^Ftr, Gs^Fms, Gs^Fms, Gs^Fms, Gs^Fms
Gg, Gg, Gg, Rr, Gs^Fms, Gs^Fms, Gs^Fms, Gs^Fms, Gs^Fms, Aa, Gs^Fms, Gs^Fms, Gs^Fms, Gll^Ftr, Gll^Ftr, Gll^Ftr, Gll^Ftr, Gll^Ftr, Gll^Ftr, Sm, Gll^Ftr, Gll^Ftr, Gs^Fms, Gs^Fms, Gs^Fms, Gs^Fms, Gs^Fms, Gs^Fms
Gg, Gg, Gg, Rr, Gs^Fms, Gs^Fms, Gs^Fms, Gs^Fms, Gs^Fms, Gs^Fms, Gs^Fms, Gs^Fms, Gs^Fms, Gll^Ftr, Gll^Ftr, Gll^Ftr, Gll^Ftr, Gll^Ftr, Sm, Sm, Hh, Gll^Ftr, Gs^Fms, Gs^Fms, Gs^Fms, Gs^Fms, Gs^Fms, Hh
Gg, Gg, Gg, Rr, Gs^Fms, Gs^Fms, Gs^Fms, Gs^Fms, Gs^Fms, Gs^Fms, Gs^Fms, Gs^Fms, Gs^Fms, Gs^Fms, Gs^Fms, Gll^Ftr, Gs^Fms, Gll^Ftr, Sm, Sm, Sm, Gll^Ftr, Gs^Fms, Gs^Fms, Gs^Fms, Gs^Fms, Gs^Fms, Hh
Gg, Gg, Gg, Rr, Gs^Fms, Gs^Fms, Gs^Fms, Gll^Fp, Gs^Fms, Gs^Fms, Gs^Fms, Gs^Fms, Gs^Fms, Gs^Fms, Gs^Fms, Gs^Fms, Gs^Fms, Gs^Fms, Gs^Fms, Sm, Gs^Fms, Gs^Fms, Gs^Fms, Gs^Fms, Gs^Fms, Gs^Fms, Gs^Fms, Gs^Fms
Gg, Gg, Gg, Rr, Gs^Fms, Gg, Gg, Gs^Fms, Gs^Fms, Gs^Fms, Gs^Fms, Gs^Fms, Gs^Fms, Gs^Fms, Gs^Fms, Gs^Fp, Sm, Gg, Gg^Es, Gg^Fet, Gg, Gg, Gs^Fms, Gs^Fms, Gs^Fms, Aa, Gs^Fms, Gs^Fms
Gg, Gg, Gg, Gs^Fms, Gs^Fms, Gg, Gg, Gs^Fms, Gs^Fms, Gs^Fms, Gs^Fms, Gs^Fms, Ss, Gs^Fms, Ss, Ss, Gs^Fp, Gs^Fms, Gs^Fms, Gg, Gg, Gg, Gg, Gs^Fms, Gs^Fms, Gs^Fms, Gs^Fms, Gs^Fms
Gg, Gg, Gs^Fms, Gs^Fms, Gs^Fms, Gs^Fms, Gll^Ftr, Gll^Ftr, Gg^Es, Gg, Gg, Gg, Gs^Fms, Sm, Gs^Fms, Gg, Gg, Ss, Gs^Fp, Gs^Fms, Gs^Fms, Gs^Fms, Gg, Gs^Fms, Gs^Fms, Gs^Fms, Gs^Fms, Gs^Fms
Gg, Gs^Fms, Gs^Fms, Gs^Fms, Gs^Fms, Gll^Ftr, Gg, Gg, Gg, Gg, Gg, Gs^Fms, Gs^Fms, Gs^Fms, Gs^Fms, Gg, Gs^Fp, Gs^Fp, Gs^Fp, Gs^Fp, Gs^Fms, Gg, Gg, Gs^Fms, Gs^Fms, Gs^Fms, Gs^Fms, Gs^Fms
Gg, Gg, Gs^Fms, Gs^Fms, Gs^Fms, Gll^Ftr, Gg, Gg, Gg, Gg^Es, Gg, Gs^Fms, Gs^Fms, Gs^Fms, Gs^Fms, Gs^Fms, Ss, Gg^Es, Ss, Gs^Fp, Ss, Sm, Gs^Fms, Gs^Fms, Gs^Fp, Gs^Fms, Gs^Fms, Gs^Fms
Gg, Gg, Gs^Fms, Gs^Fms, Gs^Fms, Gll^Ftr, Gg, Gg, Gll^Fp, Gll^Fp, Gll^Fp, Gll^Fp, Gs^Fms, Gs^Fms, Gs^Fms, Gs^Fms, Ss, Sm, Gs^Fp, Ss, Gs^Fp, Gs^Fms, Gs^Fms, Gs^Fms, Gs^Fms, Gs^Fms, Gs^Fms, Gs^Fms
Rr, Rr, Gs^Fms, Gs^Fms, Gs^Fms, Gs^Fms, Gll^Fp, Sm, Ss, Ss, Sm, Gll^Fp, Gs^Fms, Gg, Gg, Gs^Fds, Gs^Fds, Gs^Fds, Gs^Fds, Gs^Fms, Gs^Fms, Gs^Fms, Gs^Fms, Gs^Fms, Gs^Fms, Gs^Fms, Gs^Fms, Gs^Fms
Rr, Gs^Fms, Gs^Fp, Gs^Fms, Gs^Fms, Gs^Fms, Gll^Fp, Gll^Fp, Ss, Ss, Sm, Gll^Fp, Gs^Fds, Gg, Gs, Gs, Gg, Gs, Gs^Fds, Gs^Fms, Gs^Fms, Gs^Fms, Gs^Fms, Gs^Fms, Gs^Fms, Gs^Fms, Gs^Fms, Gs^Fms
Gs^Fms, Gs^Fms, Gs^Fms, Gs^Fms, Gs^Fms, Gs^Fms, Gll^Fp, Gll^Fp, Sm, Sm, Ss, Gll^Fp, Ss, Gs, Gg, Gs, Gg^Efm, Gg, Gs^Fds, Gs^Fms, Gs^Fms, Gs^Fms, Gs^Fms, Gs^Fms, Gs^Fms, Gs^Fms, Gs^Fms, Gs^Fms
Gll^Fp, Gll^Fp, Gll^Fp, Gll^Fp, Gll^Fp, Gs^Fms, Gs^Fms, Gll^Fp, Ss, Ss, Ss, Sm, Gll^Fp, Gs, Gg, Gg^Efm, Wot^Eb, Gg^Efm, Gs, Gs^Fds, Gs^Fds, Gs^Fms, Gs^Fms, Gs^Fms, Gs^Fms, Gs^Fms, Gs^Fms, Gs^Fms
Gll^Fp, Gll^Fp, Mm, Gll^Fp, Gll^Fp, Gll^Fp, Gll^Fp, Gs^Fms, Sm, Ss, Gll^Fp, Gll^Fp, Gll^Fp, Gg, Gs^Es, Gg^Efm, Gg^Efm, Gg^Efm, Gs, Gg, Gs^Fds, Gs^Fms, Gs^Fms, Gs^Fms, Gs^Fms, Hh, Hh, Gs^Fms
Gs^Fms, Gll^Fp, Gll^Fp, Gll^Fp, Gll^Fp, Gll^Fp, Gll^Fp, Gll^Fp, Gll^Fp, Sm, Gll^Fp, Gs^Fms, Gs^Fms, Gll^Fp, Gll^Fp, Gs, Ss, Gg, Gs, Gs^Fds, Gs^Fms, Gs^Fms, Gs^Fms, Gs^Fms, Gs^Fms, Gs^Fms, Gs^Fms, Gs^Fms
Gll^Fp, Gs^Fms, Gs^Fms, Gs^Fms, Gs^Fms, Gll^Fp, Gll^Fp, Gll^Fp, Gs^Fms, Gll^Fp, Gs^Fms, Gs^Fms, Gs^Fms, Ss, Sm, Sm, Gg^Fet, Ss, Ss, Gs^Fms, Gs^Fms, Gs^Fms, Gs^Fms, Gs^Fms, Gs^Fms, Gs^Fms, Gs^Fms, Gs^Fms
Aa, Gs^Fms, Gs^Fms, Aa, Aa, Gs^Fms, Gs^Fms, Gs^Fms, Gs^Fms, Gs^Fms, Gs^Fms, Gs^Fms, Gs^Fms, Ss, Ss, Ss, Sm, Sm, Gs^Fms, Gll^Fp, Gs^Fms, Gs^Fms, Gs^Fms, Gs^Fms, Gs^Fms, Gs^Fms, Gs^Fms, Gs^Fms
Gs^Fms, Gs^Fms, Gs^Fms, Aa, Aa, Gs^Fms, Gs^Fms, Gs^Fms, Gs^Fms, Gs^Fms, Gs^Fms, Gs^Fms, Gll^Fp, Gs^Fms, Sm, Ss, Gll^Fp, Ss, Gs^Fms, Gs^Fms, Gs^Fms, Gs^Fms, Gs^Fms, Gs^Fms, Gs^Fms, Gs^Fms, Gs^Fms, Gs^Fms
Gs^Fms, Gs^Fms, Gs^Fms, Aa, Aa, Gs^Fms, Gs^Fms, Gs^Fms, Gs^Fms, Gs^Fms, Gs^Fms, Gs^Fms, Gs, Gs, Gs^Fms, Gs^Fms, Gs^Fms, Gs^Fms, Gs^Fms, Gs^Fms, Gs^Fms, Gs^Fms, Gs^Fms, Gs^Fms, Gs^Fms, Gs^Fms, Gs^Fms, Gs^Fms
Gs^Fms, Gs^Fms, Gs^Fms, Gs^Fms, Gs^Fms, Gs^Fms, Gs^Fms, Gs^Fms, Gs^Fms, Gs^Fms, Gs^Fms, Gs, Gg, Gs^Fms, Gs^Fms, Gs^Fms, Gs^Fms, Gs^Fms, Gs^Fms, Gs^Fms, Gs^Fms, Gs^Fms, Gs^Fms, Gs^Fms, Gs^Fms, Gs^Fms, Gs^Fms, Gs^Fms
Rr, Gs^Fms, Gs^Fms, Gs^Fms, Gs^Fms, Aa, Aa, Gs^Fms, Gs^Fms, Gs^Fms, Gs^Fms, Gs^Fms, Gs^Fms, Gg, Gg, Gs^Fms, Gs^Fms, Gs^Fms, 2 Gs, Gs^Fp, 3 Gs, Gs^Fms, Gs^Fp, Gs^Fms, Gs^Fp, Gs^Fp, Gs^Fp, Hh
Hh, Rr, Gs^Fms, Gs^Fms, Gs^Fms, Aa, Aa, Gs^Fms, Gs^Fms, Gs^Fms, Gs^Fms, Gs^Fms, Gs^Fms, Gs^Fms, Gs, Gs, Gs, 5 Gs, Gs, 4 Gs, Gs, Gs, Gs^Fp, Gs^Fp, Gs^Fp, Gs^Fp, Gs^Fp, Hh
Mm, Rr, Hh, Hh, Gs^Fms, Gs^Fms, Aa, Gs^Fms, Gs^Fms, Gs^Fms, Gs^Fms, Gs^Fms, Gs^Fms, Gs, Gs, Gs, Gs, Gs, Gs, Gs, Gs, Gs, Gs^Fp, Gs^Fp, Hh, Hh, Hh, Mm
